........................
..WWWWWWWWWWWWWWWWWWW...
..W#B#B#B#!#!#B#B#B#WW..
..W!#!#K#!WWW!#!#!#LFW..
..W#!#!#L#WWW#!#!#!#FW..
..W!#!#!#!WWW!#!#!#!WW..
..W#!#!#!#WWW#!#!#!#W...
..W!#!#!#!WWWR#!#!#!W...
.WW#R#!#!#WWW#!#!#!#W...
.W,!#!#!#!WWW!#!#!#!W...
.W@#!#!#!#WWW#!#K#!#W...
.WWT#T#T#T#!#T#T#T#TW...
..WWWWWWWWWWWWWWWWWWW...
........................