........................
........................
........................
........................
..WWWWWWW.....WWWWWWW...
..W,@,,,W.....WFFFFFW...
..W!#!#!W.....W!#!#!W...
...W!#!#LW...W!#!#LW....
....WR#!#!WWWR#!#!W.....
.....WR#!#!#!#!#!W......
......W!#!#!#!#!W.......
.......WWWWWWWWW........
........................
........................