........................
..WWWWWWWWWWWWWWWWWWW...
..W#B#B#B#!#!#B#B#B#WWW.
..W!#!#K#!WWW!#!#!#LFFW.
..W#!#!#L#WWW#!#!#!#FFW.
..W!#!#!#!WWW!#!#!#!WWW.
..W#!#!#!#WWW#!#!#!#W...
..W!#!#!#!WWWR#!#!#!W...
WWW#R#!#!#WWW#!#!#!#W...
W@,!#!#!#!WWW!#!#!#!W...
W,,#!#!#!#WWW#!#K#!#W...
WWWT#T#T#T#!#T#T#T#TW...
..WWWWWWWWWWWWWWWWWWW...
........................