........................
..WWWWWWWWWWWWWWWWWWW...
..W#B#B#B#!#!#B#B#B#WW..
..W!#!#K#!WWW!#!#!#LFW..
..W#R#!#!#WWW#!#!#!#FW..
..W!#!#!#!WWW!#!#!#LWW..
..W#R#!#!#WWW#!#!#!#W...
..W!#!#!#!WWW!#!#!#LW...
.WW#R#!#!#WWW#!#!#!#W...
.W,!#!#!#!WWW!#!#!#!W...
.W@#!#!#!#WWW#!#K#!#W...
.WWT#T#T#T#!#T#T#T#TW...
..WWWWWWWWWWWWWWWWWWW...
........................