........................
........................
....WWWWWWWWWWWWWW......
....Wk!#!#!#!#!#KW......
....W!#!#!#!#!#!#W......
.WWWW#!#!#!#!#!#!WWWW...
.W@,,!Z!Z!Z!Z!Z!ZFFFW...
.W,,,X!X!X!X!X!X!FFFW...
.WWWW!#!#!#!#!#!#WWWW...
....W#!#!#!#!#!#!W......
....WK#!#!#!#!#!kW......
....WWWWWWWWWWWWWW......