........................
........................
........................
..WWWWW........WWWWWWW..
..W,,,WWWWWWWWWW!#FFFW..
..W,@,WR#!#!#!#!#WFFFW..
..W,,,W#!#!#!#!#LWFFFW..
..W,,,WR#!#!#!#!#WFFFW..
..W,,,W#!#!#!#!#LWFFFW..
..W,,,#!WWWWWWWWWWFFFW..
..WWWWWWW........WWWWW..
........................
........................
........................