........................
........................
........................
........................
...,,,..........!#,,,...
...,@,.X#!#!#!#!#.,,,...
...,,,.#!#!#!#!#X.,,,...
...,,,.X#!#!#!#!#.,,,...
...,,,.#!#!#!#!#X.,,,...
...,,,#!..........,,,...
........................
........................
........................
........................