........................
........................
........................
....................WWW.
....WWW.....WWW.....WFW.
.WWWW!WWWWWWW!WWWWWWW!W.
.WR#!#!#!#!#!#!#!#!#!LW.
.WR!#!#!#!#!#!#!#!#!#LW.
.W!WWWWWW#WWWWWWW#WWWWW.
.W@W....WWW.....WWW.....
.WWW....................
........................
........................
........................