........................
........................
........................
........................
...,,,..........!#,,,...
...,@,.!#!#!#!#!#.,,,...
...,,,.#!#!#!#!#!.,,,...
...,,,.!#!#!#!#!#.,,,...
...,,,.#!#!#!#!#!.,,,...
...,,,#!..........,,,...
........................
........................
........................
........................