........................
........................
........................
........................
...,,,..........!#,,,...
...,@,.R#!#!#!#!#.,,,...
...,,,.#!#!#!#!#L.,,,...
...,,,.R#!#!#!#!#.,,,...
...,,,.#!#!#!#!#L.,,,...
...,,,#!..........,,,...
........................
........................
........................
........................