........................
........................
........................
..WWWWW........WWWWWWW..
..W,,,WWWWWWWWWW!#,,,W..
..W,@,WR#!#!#!#!#W,,,W..
..W,,,W#!#!#!#!#LW,,,W..
..W,,,WR#!#!#!#!#W,,,W..
..W,,,W#!#!#!#!#LW,,,W..
..W,,,#!WWWWWWWWWW,,,W..
..WWWWWWW........WWWWW..
........................
........................
........................